21 21
#####################
#K#................P#
#.#.................#
#.#.T....W.......T..#
#.#.................#
#.#...........W.....#
#.#.................#
#.#....N.....N......#
#.#.................#
#.#..D.........D....#
#.#.................#
#.#.................#
#.#.................#
#.#.C..Z..C...Z...C.#
#.#.................#
#...................#
#...................#
#...................#
#...................#
#...................#
#####################
